00000000000X000000
00000000X000000000
0000F000L000000000
000000000000000X00
000000000000000000
000000000000000000
X000000000000X00X0
000000000000XXX000
0000000X00000X0000
00000X000000000X00
0X00000000000X0000
X0000000000000000X
XX000000000000X000
000000X0000000K000
000000000X000000X0
X0P000000000000000
0XXX00000000000000
000000000000000000