0X00000000X0
XXX000000XXX
0X00000000X0
000000000000
000000000000
0XP0000000X0
XXX000000XXX
0X00000000X0